en : eins
katt : Katze
jeg : ICH
ha : haben
derett : genau da
ut : aus
å : Zu
lill : wenig
slektning : relativ
hjem : heim
hun : sie
har : Haar
kunn : könnte
saml : Sammlung
sjans : Chance
kultur : Kultur
den : Es
fra : aus
alltid : stets
henn : ihr
ble : wurde
funn : Ergebnisse
fortalt : erzählt
hverandr : gegenseitig
vår : unser
lytt : Hören
mang : viele
jent : Mädchen
hørt : gehört
bar : Bar
de : Die
histori : Geschichte
stirr : starrt
er : Ist
dag : Tag
av : von
ting : Ding
spent : aufgeregt
så : So
skull : Schädel
vet : wissen
bestemm : entscheiden
spenn : Spanne
varm : warm
fortell : erzählen
glipp : vermissen
lært : gelernt
hver : jede
sjel : Seele
som : als
nye : neu
lepp : Lippe
lit : zündete
ingenting : Nichts
veil : Straße
bodd : lebte
bestemor : Oma
alt : alles
deg : Du
nødvend : Notfall
min : Mein
råd : Beratung
kjent : bekannt
da : Dann
viktiger : wichtiger
ung : jung
skog : Wald
smil : lächeln
eventyr : Märchen
koffer : Koffer
seg : sich
tid : Zeit
møtt : getroffen
lengt : lang
reist : gereist
la : lassen
ny : neu
sid : Buchseite
begynt : begonnen
måned : Monat
dra : ziehen
klok : weise
tog : Zug
sted : Ort
fjell : Berg
aldri : niemals
ved : von
takknem : dankbar
oppsøk : ausfindig machen
støtt : Unterstützung
ønsk : Verlangen
satt : saß
tår : Tränen
det : Die
innså : erkannte
landsby : Dorf
nå : Jetzt
ord : Wort
på : An
søkt : gesucht
eksotisk : exotisch
et : A
planlegg : planen
spektakulær : spektakulär
øyn : Auge
samm : zusammen
egen : eigen
følt : gefühlt
god : Gut
lapp : Patch
hvor : Wo
minn : Speicher
vakr : Schön
fantastisk : fantastisch
reis : Reise
ga : gehen
frod : blühen
enn : als
men : Aber
om : um
uken : die Woche
gnist : Funke
tilhør : gehören
best : am besten
inn : In
for : für
lovt : gestattet
skal : soll
stor : groß
strend : Strand
eventyrlyst : Abenteuergeist
vent : Warten
gang : Zeit
veranda : Balkon
din : dein
åpn : offen
språk : Sprache
navn : Name
drømt : geträumt
og : Und
underveis : nach dem Weg
opplevd : erfahren
uansett : trotzdem
tok : nahm
adress : Adresse
hjert : Herz
til : Zu
all : alle
strålt : strahlte
oppdag : entdecken
sett : Satz
i : In
fylt : gefüllt
gjord : Erledigt
fjern : Fernbedienung
verd : Wert
gammel : alt
rund : runden
ett : eins
tilbak : zurück
vandr : Wasser
opplev : Erfahrung
vær : Wetter
mot : gegen
over : über
ulik : anders
lev : live
kvinn : Frau
der : Dort
ditt : dein
klem : Umarmung
omfavn : umarmen
stolt : stolz
gjennom : durch
besøkt : hat besucht
gikk : ging
sar : Wunde
utenfor : außen
del : Aktie
hvilk : welche
bekymr : Anliegen
hjemm : heim
byen : Stadt
vill : wild
at : Das
med : mit
mat : Essen
land : Land
fremmed : Fremder
drømm : Traum
kjær : Liebling
ta : Zehe
smakt : geschmeckt
sitt : sitzen
oppfyll : erfüllen
majestetisk : majestätisch
husk : erinnern
bestemt : Spezifisch
mennesk : menschlich
var : unser
overveld : überwältigen
hel : ganz
gled : ausgerutscht
flyet : das Flugzeug
sa : So
kom : kommen
hadd : hatte
beundring : Bewunderung
også : Auch
du : Du
når : Wenn
utforsk : erkunden
klemt : eingeklemmt
sin : sein
besøk : besuchen
komm : Komm
selv : selbst
levd : lebte
visst : Sicher
hjemkomst : Heimkehr
før : für
hallo : Hallo
